WTTTTXTTTT

TTTTTTXTTT

TTTTTTTTTT

TTTTTTTTXT

TTXXTTTTXT

TXZTTTTTX2