WTTTTTTXHZ
T3TTTTT1HT
TTTTTTTXHT
XXHFT2TTTT
ZTTTTTTTTZ