WTTTTTTTXZ

TTTTTTTTXT

TTTTTTTTXT

TTTTTXTXTT

TTTTTTXTTT

TTXTTTTTTT
TXXTTTTTTT

2XTTTTTTTT

