WTTTTTTXXZ
T3TTTTT1XT
TTTTTTTXXT
XXXTT2TTTT
ZTTTTTTTTZ